11111111111111111111
11111000111000111111
11110000010000011111
11110000000000011111
11110000000000011111
1111100P0E0C0C111111
11111100000001111111
11111110000011111111
11111111000111111111
11111111101111111111
11111111111111111111