1111111111111
100E000000011
100C000010001
100P011110101
1111111111111