11111111111111111111
10000000000000000001
10C0000E001000001011
1000000P10101010C011
10000000000000000001
11111111111111111111